###############################
# - # - # # # # - # - # # - # #
#-#-#-###-#-#-#-###-#-#-#-###-#
# # - # - - - - # - # - - - - #
#-#-#-#-#-#-#-###-#-#-###-###-#
# - # - - # # # # # - - - # - #
###-###-#-#-#-#-#-#-###-#-#-#-#
# - - - - - - # - # - - # - - #
###-#-#####-#-###-#-###-#-###-#
# # - # - - # - - # - - # - - #
#####-###-###-#-#-#-###-#-###-#
# - # - - # - - - # # # - # - #
#-#-#-#-###-#-###-#-#-#####-#-#
# # - - - - # # - # # - - - - #
###-###-#-###-###-#-#-###-###-#
# - - - - # - - # # - # - - - #
#####-#-#-#-###-###-#-###-#-#-#
# # - # # - # # - - - - - - - #
#-#-#-#-###-#-###-#-###-#-###-#
# - # # - - - - - - - - - - - #
#-#-#-###-#-#-###-#-#-#-#####-#
# # - - - - # - - # # - # - - #
#####-###-#-###-#-###-###-#-#-#
# - # - - - - - - - - - - - - #
#-#-#-###-#-#-#-###-#-###-###-#
# - - - # # # # - - - - - - - #
###-###-#-#-#-#-#-###-###-#-#-#
# - - - - - - # # # # - - - - #
###-#-#-#####-#-#-###-#-#-###-#
# - # - - # - # - - # - # # - #
###############################
