###############################
# - # # # - - - - # # # - # # #
#-#-#-#-#####-#####-#-#-#-#-#-#
# # - # - # # - - - - - # # - #
#-###-#-#####-#-###-#-#-#-###-#
# - - - - - # # - - - - # - - #
#######-#-#-#-#####-#-#-###-#-#
# - - - # # - - - # # - - - - #
###-#-#-#####-###-#-#-#-#-#-#-#
# - # - - - # # # - # - - - - #
#-#-#######-#-#-#-###-###-#-#-#
# # # - - - # - - - - # # # - #
###-#-#-#-#-#-#-#-#-#-###-###-#
# - # # - # # - # # - # # # - #
#####-#-#-###-#-#-#-#-#-#-###-#
# - - - # - # - # - - - # - - #
###-#-#-#-#-#-###-#-###-#-#-#-#
# - - - - # # # - # # - - # - #
#-#-###-###-#-#-#-#-#-###-###-#
# # # # - # - - - # # - - - - #
###-#-#-#-#####-###-#-###-#-#-#
# - - - # - # # - - - - # - - #
###-#-#-###-#-#-#-#-###-#-###-#
# - # - - - - - - - # # - # - #
###-#-#-#-###-#-#-#####-###-#-#
# # - - - - - - - - - - - # - #
#-#-###-#-#-#-#-#-#-###-#-#-#-#
# - - # - # - - - - # - # # - #
#-###-###-#-###-###-#-#-#-###-#
# # - - # # - - # # # - # - - #
###############################
