
------------------
-################-
-#######*#*######-   ----------
-########-#######-   -########-
-########-#######-----########-
-########-##*###*#####*#######-
-########---####*#####*#######-
-#######*###*####-----########-
-################-   -########-
-################-   ----------
-################-
------------------